OOOOOOOOOOOOOOOOOOOOOOOOOOOOOOOOOOOOOOOO
O OO      .OOOOOOOOOO         OO      OO
O OO OOOOOO     OOOOOOO.OOOOO OO.OOOO  O
O    OOOOOO OOOOOOO OOO    OO OO OOOO.OO
OOOOO  OOO  O    OO OO OOO OO.OO.O    OO
O . OOO    OOOOO.OO OO OOO OO    OO OOOO
O O OOOOOOOOOOOO OO OO O . OOOOOOOO O OO
O O              OO OO O OO OO OOOO.O.OO
O O OOOOOOOOOOOO.OO.OO O OO OO      O OO
O O OOOOO           OO.O.OO    OOOOOO.OO
O O OOOOOOOOOOOOOOOOOO O OO OOOO      OO
O O OO                   OO O    OO.OOOO
O O OO OOOOOOOOOOOOOOOOO.OO O OO OO    O
O O   .           .      OO   O   O OOOO
O OOO OOO O OOOOOOOOOOOOOOO O O.OOOOOOOO
OO OO OO  O OOOO        OOO O OO       U
O  OO OO OO      OOOOOO  OO.O.OOOOO.OOOO
O OOO OO   OOOOOOOOOOOO.OOO O    OO OOOO
O  .  OOOO              O   OOOOO   OOOO
OOOOOOOOOOOOOOOOOOOOOOOOOOOOOOOOOOOOOOOO
